"aq" = (/obj/structure/simple_door/private/inner{accommodation_id = CB-131},/turf/open/floor/carpet/blue,/area/if13/building/accommodation)
"aC" = (/obj/structure/simple_door/private/inner{accommodation_id = CB-135},/turf/open/floor/carpet/blue,/area/if13/building/accommodation)
"bt" = (/obj/structure/simple_door/private/inner{accommodation_id = CB-110},/turf/open/floor/carpet/blue,/area/if13/building/accommodation)
"bx" = (/obj/structure/simple_door/private/inner{accommodation_id = CB-125},/turf/open/floor/carpet/blue,/area/if13/building/accommodation)
"bW" = (/obj/structure/simple_door/private/inner{accommodation_id = CB-116},/turf/open/floor/carpet/blue,/area/if13/building/accommodation)
"cN" = (/obj/structure/simple_door/private/inner{accommodation_id = CB-106},/turf/open/floor/carpet/blue,/area/if13/building/accommodation)
"dr" = (/obj/structure/simple_door/private/inner{accommodation_id = CB-111},/turf/open/floor/carpet/blue,/area/if13/building/accommodation)
"dX" = (/obj/structure/simple_door/private/inner{accommodation_id = CB-132},/turf/open/floor/carpet/blue,/area/if13/building/accommodation)
"ec" = (/obj/structure/simple_door/private/inner{accommodation_id = CB-114},/turf/open/floor/carpet/blue,/area/if13/building/accommodation)
"fI" = (/obj/structure/simple_door/private/inner{accommodation_id = CB-107},/turf/open/floor/carpet/blue,/area/if13/building/accommodation)
"hG" = (/obj/structure/simple_door/private/inner{accommodation_id = CB-150},/turf/open/floor/carpet/blue,/area/if13/building/accommodation)
"hO" = (/obj/structure/simple_door/private/inner{accommodation_id = CB-105},/turf/open/floor/carpet/blue,/area/if13/building/accommodation)
"iE" = (/obj/structure/sink{dir = 4; pixel_x = -13; pixel_y = -4},/obj/structure/mirror/directional/west,/turf/open/floor/iron/inferno{icon_state = "whitegreenchess"},/area/if13/building/accommodation)
"iV" = (/obj/structure/simple_door/private/inner{accommodation_id = CB-122},/turf/open/floor/carpet/blue,/area/if13/building/accommodation)
"ke" = (/obj/structure/simple_door/private/inner{accommodation_id = CB-136},/turf/open/floor/carpet/blue,/area/if13/building/accommodation)
"kh" = (/obj/structure/simple_door/private/inner{accommodation_id = CB-139},/turf/open/floor/carpet/blue,/area/if13/building/accommodation)
"kv" = (/obj/structure/simple_door/private/inner{accommodation_id = CB-134},/turf/open/floor/carpet/blue,/area/if13/building/accommodation)
"kP" = (/obj/structure/simple_door/private/inner{accommodation_id = CB-128},/turf/open/floor/carpet/blue,/area/if13/building/accommodation)
"li" = (/obj/structure/simple_door/private/inner{accommodation_id = CB-126},/turf/open/floor/carpet/blue,/area/if13/building/accommodation)
"lA" = (/obj/structure/simple_door/private/inner{accommodation_id = CB-129},/turf/open/floor/carpet/blue,/area/if13/building/accommodation)
"mO" = (/obj/structure/toilet{pixel_y = 10},/turf/open/floor/iron/inferno{icon_state = "whitegreenchess"},/area/if13/building/accommodation)
"mY" = (/obj/structure/simple_door/private/inner{accommodation_id = CB-112},/turf/open/floor/carpet/blue,/area/if13/building/accommodation)
"nC" = (/obj/structure/simple_door/private/inner{accommodation_id = CB-138},/turf/open/floor/carpet/blue,/area/if13/building/accommodation)
"om" = (/obj/structure/simple_door/private/inner{accommodation_id = CB-103},/turf/open/floor/carpet/blue,/area/if13/building/accommodation)
"pA" = (/obj/machinery/door_panel,/turf/closed/wall/concrete,/area/if13/building/accommodation)
"pH" = (/obj/structure/simple_door/private/inner{accommodation_id = CB-118},/turf/open/floor/carpet/blue,/area/if13/building/accommodation)
"pV" = (/obj/structure/simple_door/house,/turf/open/floor/iron/inferno{icon_state = "whitegreenchess"},/area/if13/building/accommodation)
"qB" = (/obj/structure/simple_door/private/inner{accommodation_id = CB-137},/turf/open/floor/carpet/blue,/area/if13/building/accommodation)
"sn" = (/turf/closed/wall/concrete,/area/if13/building/accommodation)
"sM" = (/obj/structure/simple_door/private/inner{accommodation_id = CB-124},/turf/open/floor/carpet/blue,/area/if13/building/accommodation)
"sS" = (/obj/structure/simple_door/private/inner{accommodation_id = CB-148},/turf/open/floor/carpet/blue,/area/if13/building/accommodation)
"tL" = (/obj/structure/simple_door/private/inner{accommodation_id = CB-130},/turf/open/floor/carpet/blue,/area/if13/building/accommodation)
"vA" = (/obj/machinery/shower{dir = 8},/turf/open/floor/iron/inferno{icon_state = "whitegreenchess"},/area/if13/building/accommodation)
"wh" = (/obj/structure/simple_door/private/inner{accommodation_id = CB-127},/turf/open/floor/carpet/blue,/area/if13/building/accommodation)
"wN" = (/obj/structure/simple_door/private/inner{accommodation_id = CB-108},/turf/open/floor/carpet/blue,/area/if13/building/accommodation)
"wV" = (/obj/machinery/light/directional/north,/turf/open/floor/carpet/blue,/area/if13/building/accommodation)
"xN" = (/turf/open/floor/iron/inferno{icon_state = "whitegreenchess"},/area/if13/building/accommodation)
"Ag" = (/obj/structure/simple_door/private/inner{accommodation_id = CB-151},/turf/open/floor/carpet/blue,/area/if13/building/accommodation)
"Am" = (/obj/structure/simple_door/private/inner{accommodation_id = CB-146},/turf/open/floor/carpet/blue,/area/if13/building/accommodation)
"AK" = (/obj/machinery/light/directional/south,/turf/open/floor/carpet/blue,/area/if13/building/accommodation)
"BI" = (/obj/structure/simple_door/private/inner{accommodation_id = CB-143},/turf/open/floor/carpet/blue,/area/if13/building/accommodation)
"CV" = (/obj/structure/simple_door/private/inner{accommodation_id = CB-121},/turf/open/floor/carpet/blue,/area/if13/building/accommodation)
"Eb" = (/obj/structure/simple_door/private/inner{accommodation_id = CB-119},/turf/open/floor/carpet/blue,/area/if13/building/accommodation)
"EI" = (/obj/structure/simple_door/private/inner{accommodation_id = CB-113},/turf/open/floor/carpet/blue,/area/if13/building/accommodation)
"Fv" = (/turf/open/floor/carpet/blue,/area/if13/building/accommodation)
"Gh" = (/obj/structure/simple_door/private/inner{accommodation_id = CB-104},/turf/open/floor/carpet/blue,/area/if13/building/accommodation)
"Hp" = (/obj/structure/simple_door/private/inner{accommodation_id = CB-120},/turf/open/floor/carpet/blue,/area/if13/building/accommodation)
"IV" = (/obj/structure/simple_door/private/inner{accommodation_id = CB-140},/turf/open/floor/carpet/blue,/area/if13/building/accommodation)
"KO" = (/obj/structure/simple_door/private/inner{accommodation_id = CB-141},/turf/open/floor/carpet/blue,/area/if13/building/accommodation)
"LY" = (/obj/machinery/light/directional/west,/turf/open/floor/iron/inferno{icon_state = "whitegreenchess"},/area/if13/building/accommodation)
"Oi" = (/obj/structure/simple_door/private/inner{accommodation_id = CB-149},/turf/open/floor/carpet/blue,/area/if13/building/accommodation)
"On" = (/obj/structure/simple_door/private/inner{accommodation_id = CB-144},/turf/open/floor/carpet/blue,/area/if13/building/accommodation)
"Oq" = (/obj/structure/simple_door/private/inner{accommodation_id = CB-133},/turf/open/floor/carpet/blue,/area/if13/building/accommodation)
"OF" = (/obj/structure/simple_door/private/inner{accommodation_id = CB-145},/turf/open/floor/carpet/blue,/area/if13/building/accommodation)
"RT" = (/obj/structure/simple_door/private/inner{accommodation_id = CB-115},/turf/open/floor/carpet/blue,/area/if13/building/accommodation)
"UP" = (/obj/structure/simple_door/private/inner{accommodation_id = CB-109},/turf/open/floor/carpet/blue,/area/if13/building/accommodation)
"Vl" = (/obj/structure/simple_door/private/inner{accommodation_id = CB-142},/turf/open/floor/carpet/blue,/area/if13/building/accommodation)
"WM" = (/obj/structure/simple_door/private/inner{accommodation_id = CB-117},/turf/open/floor/carpet/blue,/area/if13/building/accommodation)
"WZ" = (/obj/structure/simple_door/private/inner{accommodation_id = CB-147},/turf/open/floor/carpet/blue,/area/if13/building/accommodation)
"Yz" = (/obj/structure/simple_door/private/inner{accommodation_id = CB-123},/turf/open/floor/carpet/blue,/area/if13/building/accommodation)
"Zm" = (/obj/structure/simple_door/private/inner{accommodation_id = CB-101},/turf/open/floor/carpet/blue,/area/if13/building/accommodation)
"ZQ" = (/obj/structure/simple_door/private/inner{accommodation_id = CB-102},/turf/open/floor/carpet/blue,/area/if13/building/accommodation)

(1,1,1) = {"
snsnsnsnsnsnsnsnsnsnsnsnsnsnsnsnsnsnsnsnsnsnsnsnsnsnsnsnsnsnsnsnsnsnsnsnsnsnsnsnsnsnsnsnsnsnsnsnsnsnsnsnsnsnsnsnsnsnsnsnsnsnsnsnsnsnsnsnsnsnsnsnsnsnsnsnsnsnsnsnsnsnsnsnsnsnsnsnsnsnsnsnsnsnsnsnsnsnsnsn
snmOxNvAsnFvFvwVFvsnsnsnmOxNvAsnFvFvwVFvsnsnmOxNvAsnFvFvwVFvsnsnmOxNvAsnFvFvwVFvsnsnmOxNvAsnFvFvwVFvsnsnsnsnsnsnsnsnsnsnsnsnsnsnsnsnsnsnsnsnsnsnsnsnsnsnsnsnsnsnsnsnsnsnsnsnsnsnsnsnsnsnsnsnsnsnsnsnsnsn
snLYxNxNsnFvFvFvFvsnsnsnLYxNxNsnFvFvFvFvsnsnLYxNxNsnFvFvFvFvsnsnLYxNxNsnFvFvFvFvsnsnLYxNxNsnFvFvFvFvsnsnsnsnsnsnsnsnsnsnsnsnsnsnsnsnsnsnsnsnsnsnsnsnsnsnsnsnsnsnsnsnsnsnsnsnsnsnsnsnsnsnsnsnsnsnsnsnsnsn
sniExNxNsnFvFvFvFvsnsnsniExNxNsnFvFvFvFvsnsniExNxNsnFvFvFvFvsnsniExNxNsnFvFvFvFvsnsniExNxNsnFvFvFvFvsnsnsnsnsnsnsnsnsnsnsnsnsnsnsnsnsnsnsnsnsnsnsnsnsnsnsnsnsnsnsnsnsnsnsnsnsnsnsnsnsnsnsnsnsnsnsnsnsnsn
snsnsnpVsnFvFvFvFvpAsnsnsnsnpVsnFvFvFvFvpAsnsnsnpVsnFvFvFvFvpAsnsnsnpVsnFvFvFvFvpAsnsnsnpVsnFvFvFvFvpAsnsnsnsnsnsnsnsnsnsnsnsnsnsnsnsnsnsnsnsnsnsnsnsnsnsnsnsnsnsnsnsnsnsnsnsnsnsnsnsnsnsnsnsnsnsnsnsnsn
snFvFvFvFvFvFvFvFvZmsnsnFvFvFvFvFvFvFvFvEIsnFvFvFvFvFvFvFvFvbxsnFvFvFvFvFvFvFvFvqBsnFvFvFvFvFvFvFvFvOisnsnsnsnsnsnsnsnsnsnsnsnsnsnsnsnsnsnsnsnsnsnsnsnsnsnsnsnsnsnsnsnsnsnsnsnsnsnsnsnsnsnsnsnsnsnsnsnsn
snFvFvFvAKFvFvFvFvsnsnsnFvFvFvAKFvFvFvFvsnsnFvFvFvAKFvFvFvFvsnsnFvFvFvAKFvFvFvFvsnsnFvFvFvAKFvFvFvFvsnsnsnsnsnsnsnsnsnsnsnsnsnsnsnsnsnsnsnsnsnsnsnsnsnsnsnsnsnsnsnsnsnsnsnsnsnsnsnsnsnsnsnsnsnsnsnsnsnsn
snsnsnsnsnsnsnsnsnsnsnsnsnsnsnsnsnsnsnsnsnsnsnsnsnsnsnsnsnsnsnsnsnsnsnsnsnsnsnsnsnsnsnsnsnsnsnsnsnsnsnsnsnsnsnsnsnsnsnsnsnsnsnsnsnsnsnsnsnsnsnsnsnsnsnsnsnsnsnsnsnsnsnsnsnsnsnsnsnsnsnsnsnsnsnsnsnsnsnsn
snsnsnsnsnsnsnsnsnsnsnsnsnsnsnsnsnsnsnsnsnsnsnsnsnsnsnsnsnsnsnsnsnsnsnsnsnsnsnsnsnsnsnsnsnsnsnsnsnsnsnsnsnsnsnsnsnsnsnsnsnsnsnsnsnsnsnsnsnsnsnsnsnsnsnsnsnsnsnsnsnsnsnsnsnsnsnsnsnsnsnsnsnsnsnsnsnsnsnsn
snmOxNvAsnFvFvwVFvsnsnsnmOxNvAsnFvFvwVFvsnsnmOxNvAsnFvFvwVFvsnsnmOxNvAsnFvFvwVFvsnsnmOxNvAsnFvFvwVFvsnsnsnsnsnsnsnsnsnsnsnsnsnsnsnsnsnsnsnsnsnsnsnsnsnsnsnsnsnsnsnsnsnsnsnsnsnsnsnsnsnsnsnsnsnsnsnsnsnsn
snLYxNxNsnFvFvFvFvsnsnsnLYxNxNsnFvFvFvFvsnsnLYxNxNsnFvFvFvFvsnsnLYxNxNsnFvFvFvFvsnsnLYxNxNsnFvFvFvFvsnsnsnsnsnsnsnsnsnsnsnsnsnsnsnsnsnsnsnsnsnsnsnsnsnsnsnsnsnsnsnsnsnsnsnsnsnsnsnsnsnsnsnsnsnsnsnsnsnsn
sniExNxNsnFvFvFvFvsnsnsniExNxNsnFvFvFvFvsnsniExNxNsnFvFvFvFvsnsniExNxNsnFvFvFvFvsnsniExNxNsnFvFvFvFvsnsnsnsnsnsnsnsnsnsnsnsnsnsnsnsnsnsnsnsnsnsnsnsnsnsnsnsnsnsnsnsnsnsnsnsnsnsnsnsnsnsnsnsnsnsnsnsnsnsn
snsnsnpVsnFvFvFvFvpAsnsnsnsnpVsnFvFvFvFvpAsnsnsnpVsnFvFvFvFvpAsnsnsnpVsnFvFvFvFvpAsnsnsnpVsnFvFvFvFvpAsnsnsnsnsnsnsnsnsnsnsnsnsnsnsnsnsnsnsnsnsnsnsnsnsnsnsnsnsnsnsnsnsnsnsnsnsnsnsnsnsnsnsnsnsnsnsnsnsn
snFvFvFvFvFvFvFvFvZQsnsnFvFvFvFvFvFvFvFvecsnFvFvFvFvFvFvFvFvlisnFvFvFvFvFvFvFvFvnCsnFvFvFvFvFvFvFvFvhGsnsnsnsnsnsnsnsnsnsnsnsnsnsnsnsnsnsnsnsnsnsnsnsnsnsnsnsnsnsnsnsnsnsnsnsnsnsnsnsnsnsnsnsnsnsnsnsnsn
snFvFvFvAKFvFvFvFvsnsnsnFvFvFvAKFvFvFvFvsnsnFvFvFvAKFvFvFvFvsnsnFvFvFvAKFvFvFvFvsnsnFvFvFvAKFvFvFvFvsnsnsnsnsnsnsnsnsnsnsnsnsnsnsnsnsnsnsnsnsnsnsnsnsnsnsnsnsnsnsnsnsnsnsnsnsnsnsnsnsnsnsnsnsnsnsnsnsnsn
snsnsnsnsnsnsnsnsnsnsnsnsnsnsnsnsnsnsnsnsnsnsnsnsnsnsnsnsnsnsnsnsnsnsnsnsnsnsnsnsnsnsnsnsnsnsnsnsnsnsnsnsnsnsnsnsnsnsnsnsnsnsnsnsnsnsnsnsnsnsnsnsnsnsnsnsnsnsnsnsnsnsnsnsnsnsnsnsnsnsnsnsnsnsnsnsnsnsnsn
snsnsnsnsnsnsnsnsnsnsnsnsnsnsnsnsnsnsnsnsnsnsnsnsnsnsnsnsnsnsnsnsnsnsnsnsnsnsnsnsnsnsnsnsnsnsnsnsnsnsnsnsnsnsnsnsnsnsnsnsnsnsnsnsnsnsnsnsnsnsnsnsnsnsnsnsnsnsnsnsnsnsnsnsnsnsnsnsnsnsnsnsnsnsnsnsnsnsnsn
snmOxNvAsnFvFvwVFvsnsnsnmOxNvAsnFvFvwVFvsnsnmOxNvAsnFvFvwVFvsnsnmOxNvAsnFvFvwVFvsnsnmOxNvAsnFvFvwVFvsnsnsnsnsnsnsnsnsnsnsnsnsnsnsnsnsnsnsnsnsnsnsnsnsnsnsnsnsnsnsnsnsnsnsnsnsnsnsnsnsnsnsnsnsnsnsnsnsnsn
snLYxNxNsnFvFvFvFvsnsnsnLYxNxNsnFvFvFvFvsnsnLYxNxNsnFvFvFvFvsnsnLYxNxNsnFvFvFvFvsnsnLYxNxNsnFvFvFvFvsnsnsnsnsnsnsnsnsnsnsnsnsnsnsnsnsnsnsnsnsnsnsnsnsnsnsnsnsnsnsnsnsnsnsnsnsnsnsnsnsnsnsnsnsnsnsnsnsnsn
sniExNxNsnFvFvFvFvsnsnsniExNxNsnFvFvFvFvsnsniExNxNsnFvFvFvFvsnsniExNxNsnFvFvFvFvsnsniExNxNsnFvFvFvFvsnsnsnsnsnsnsnsnsnsnsnsnsnsnsnsnsnsnsnsnsnsnsnsnsnsnsnsnsnsnsnsnsnsnsnsnsnsnsnsnsnsnsnsnsnsnsnsnsnsn
snsnsnpVsnFvFvFvFvpAsnsnsnsnpVsnFvFvFvFvpAsnsnsnpVsnFvFvFvFvpAsnsnsnpVsnFvFvFvFvpAsnsnsnpVsnFvFvFvFvpAsnsnsnsnsnsnsnsnsnsnsnsnsnsnsnsnsnsnsnsnsnsnsnsnsnsnsnsnsnsnsnsnsnsnsnsnsnsnsnsnsnsnsnsnsnsnsnsnsn
snFvFvFvFvFvFvFvFvomsnsnFvFvFvFvFvFvFvFvRTsnFvFvFvFvFvFvFvFvwhsnFvFvFvFvFvFvFvFvkhsnFvFvFvFvFvFvFvFvAgsnsnsnsnsnsnsnsnsnsnsnsnsnsnsnsnsnsnsnsnsnsnsnsnsnsnsnsnsnsnsnsnsnsnsnsnsnsnsnsnsnsnsnsnsnsnsnsnsn
snFvFvFvAKFvFvFvFvsnsnsnFvFvFvAKFvFvFvFvsnsnFvFvFvAKFvFvFvFvsnsnFvFvFvAKFvFvFvFvsnsnFvFvFvAKFvFvFvFvsnsnsnsnsnsnsnsnsnsnsnsnsnsnsnsnsnsnsnsnsnsnsnsnsnsnsnsnsnsnsnsnsnsnsnsnsnsnsnsnsnsnsnsnsnsnsnsnsnsn
snsnsnsnsnsnsnsnsnsnsnsnsnsnsnsnsnsnsnsnsnsnsnsnsnsnsnsnsnsnsnsnsnsnsnsnsnsnsnsnsnsnsnsnsnsnsnsnsnsnsnsnsnsnsnsnsnsnsnsnsnsnsnsnsnsnsnsnsnsnsnsnsnsnsnsnsnsnsnsnsnsnsnsnsnsnsnsnsnsnsnsnsnsnsnsnsnsnsnsn
snsnsnsnsnsnsnsnsnsnsnsnsnsnsnsnsnsnsnsnsnsnsnsnsnsnsnsnsnsnsnsnsnsnsnsnsnsnsnsnsnsnsnsnsnsnsnsnsnsnsnsnsnsnsnsnsnsnsnsnsnsnsnsnsnsnsnsnsnsnsnsnsnsnsnsnsnsnsnsnsnsnsnsnsnsnsnsnsnsnsnsnsnsnsnsnsnsnsnsn
snmOxNvAsnFvFvwVFvsnsnsnmOxNvAsnFvFvwVFvsnsnmOxNvAsnFvFvwVFvsnsnmOxNvAsnFvFvwVFvsnsnsnsnsnsnsnsnsnsnsnsnsnsnsnsnsnsnsnsnsnsnsnsnsnsnsnsnsnsnsnsnsnsnsnsnsnsnsnsnsnsnsnsnsnsnsnsnsnsnsnsnsnsnsnsnsnsnsnsn
snLYxNxNsnFvFvFvFvsnsnsnLYxNxNsnFvFvFvFvsnsnLYxNxNsnFvFvFvFvsnsnLYxNxNsnFvFvFvFvsnsnsnsnsnsnsnsnsnsnsnsnsnsnsnsnsnsnsnsnsnsnsnsnsnsnsnsnsnsnsnsnsnsnsnsnsnsnsnsnsnsnsnsnsnsnsnsnsnsnsnsnsnsnsnsnsnsnsnsn
sniExNxNsnFvFvFvFvsnsnsniExNxNsnFvFvFvFvsnsniExNxNsnFvFvFvFvsnsniExNxNsnFvFvFvFvsnsnsnsnsnsnsnsnsnsnsnsnsnsnsnsnsnsnsnsnsnsnsnsnsnsnsnsnsnsnsnsnsnsnsnsnsnsnsnsnsnsnsnsnsnsnsnsnsnsnsnsnsnsnsnsnsnsnsnsn
snsnsnpVsnFvFvFvFvpAsnsnsnsnpVsnFvFvFvFvpAsnsnsnpVsnFvFvFvFvpAsnsnsnpVsnFvFvFvFvpAsnsnsnsnsnsnsnsnsnsnsnsnsnsnsnsnsnsnsnsnsnsnsnsnsnsnsnsnsnsnsnsnsnsnsnsnsnsnsnsnsnsnsnsnsnsnsnsnsnsnsnsnsnsnsnsnsnsnsn
snFvFvFvFvFvFvFvFvGhsnsnFvFvFvFvFvFvFvFvbWsnFvFvFvFvFvFvFvFvkPsnFvFvFvFvFvFvFvFvIVsnsnsnsnsnsnsnsnsnsnsnsnsnsnsnsnsnsnsnsnsnsnsnsnsnsnsnsnsnsnsnsnsnsnsnsnsnsnsnsnsnsnsnsnsnsnsnsnsnsnsnsnsnsnsnsnsnsnsn
snFvFvFvAKFvFvFvFvsnsnsnFvFvFvAKFvFvFvFvsnsnFvFvFvAKFvFvFvFvsnsnFvFvFvAKFvFvFvFvsnsnsnsnsnsnsnsnsnsnsnsnsnsnsnsnsnsnsnsnsnsnsnsnsnsnsnsnsnsnsnsnsnsnsnsnsnsnsnsnsnsnsnsnsnsnsnsnsnsnsnsnsnsnsnsnsnsnsnsn
snsnsnsnsnsnsnsnsnsnsnsnsnsnsnsnsnsnsnsnsnsnsnsnsnsnsnsnsnsnsnsnsnsnsnsnsnsnsnsnsnsnsnsnsnsnsnsnsnsnsnsnsnsnsnsnsnsnsnsnsnsnsnsnsnsnsnsnsnsnsnsnsnsnsnsnsnsnsnsnsnsnsnsnsnsnsnsnsnsnsnsnsnsnsnsnsnsnsnsn
snsnsnsnsnsnsnsnsnsnsnsnsnsnsnsnsnsnsnsnsnsnsnsnsnsnsnsnsnsnsnsnsnsnsnsnsnsnsnsnsnsnsnsnsnsnsnsnsnsnsnsnsnsnsnsnsnsnsnsnsnsnsnsnsnsnsnsnsnsnsnsnsnsnsnsnsnsnsnsnsnsnsnsnsnsnsnsnsnsnsnsnsnsnsnsnsnsnsnsn
snmOxNvAsnFvFvwVFvsnsnsnmOxNvAsnFvFvwVFvsnsnmOxNvAsnFvFvwVFvsnsnmOxNvAsnFvFvwVFvsnsnsnsnsnsnsnsnsnsnsnsnsnsnsnsnsnsnsnsnsnsnsnsnsnsnsnsnsnsnsnsnsnsnsnsnsnsnsnsnsnsnsnsnsnsnsnsnsnsnsnsnsnsnsnsnsnsnsnsn
snLYxNxNsnFvFvFvFvsnsnsnLYxNxNsnFvFvFvFvsnsnLYxNxNsnFvFvFvFvsnsnLYxNxNsnFvFvFvFvsnsnsnsnsnsnsnsnsnsnsnsnsnsnsnsnsnsnsnsnsnsnsnsnsnsnsnsnsnsnsnsnsnsnsnsnsnsnsnsnsnsnsnsnsnsnsnsnsnsnsnsnsnsnsnsnsnsnsnsn
sniExNxNsnFvFvFvFvsnsnsniExNxNsnFvFvFvFvsnsniExNxNsnFvFvFvFvsnsniExNxNsnFvFvFvFvsnsnsnsnsnsnsnsnsnsnsnsnsnsnsnsnsnsnsnsnsnsnsnsnsnsnsnsnsnsnsnsnsnsnsnsnsnsnsnsnsnsnsnsnsnsnsnsnsnsnsnsnsnsnsnsnsnsnsnsn
snsnsnpVsnFvFvFvFvpAsnsnsnsnpVsnFvFvFvFvpAsnsnsnpVsnFvFvFvFvpAsnsnsnpVsnFvFvFvFvpAsnsnsnsnsnsnsnsnsnsnsnsnsnsnsnsnsnsnsnsnsnsnsnsnsnsnsnsnsnsnsnsnsnsnsnsnsnsnsnsnsnsnsnsnsnsnsnsnsnsnsnsnsnsnsnsnsnsnsn
snFvFvFvFvFvFvFvFvhOsnsnFvFvFvFvFvFvFvFvWMsnFvFvFvFvFvFvFvFvlAsnFvFvFvFvFvFvFvFvKOsnsnsnsnsnsnsnsnsnsnsnsnsnsnsnsnsnsnsnsnsnsnsnsnsnsnsnsnsnsnsnsnsnsnsnsnsnsnsnsnsnsnsnsnsnsnsnsnsnsnsnsnsnsnsnsnsnsnsn
snFvFvFvAKFvFvFvFvsnsnsnFvFvFvAKFvFvFvFvsnsnFvFvFvAKFvFvFvFvsnsnFvFvFvAKFvFvFvFvsnsnsnsnsnsnsnsnsnsnsnsnsnsnsnsnsnsnsnsnsnsnsnsnsnsnsnsnsnsnsnsnsnsnsnsnsnsnsnsnsnsnsnsnsnsnsnsnsnsnsnsnsnsnsnsnsnsnsnsn
snsnsnsnsnsnsnsnsnsnsnsnsnsnsnsnsnsnsnsnsnsnsnsnsnsnsnsnsnsnsnsnsnsnsnsnsnsnsnsnsnsnsnsnsnsnsnsnsnsnsnsnsnsnsnsnsnsnsnsnsnsnsnsnsnsnsnsnsnsnsnsnsnsnsnsnsnsnsnsnsnsnsnsnsnsnsnsnsnsnsnsnsnsnsnsnsnsnsnsn
snsnsnsnsnsnsnsnsnsnsnsnsnsnsnsnsnsnsnsnsnsnsnsnsnsnsnsnsnsnsnsnsnsnsnsnsnsnsnsnsnsnsnsnsnsnsnsnsnsnsnsnsnsnsnsnsnsnsnsnsnsnsnsnsnsnsnsnsnsnsnsnsnsnsnsnsnsnsnsnsnsnsnsnsnsnsnsnsnsnsnsnsnsnsnsnsnsnsnsn
snmOxNvAsnFvFvwVFvsnsnsnmOxNvAsnFvFvwVFvsnsnmOxNvAsnFvFvwVFvsnsnmOxNvAsnFvFvwVFvsnsnsnsnsnsnsnsnsnsnsnsnsnsnsnsnsnsnsnsnsnsnsnsnsnsnsnsnsnsnsnsnsnsnsnsnsnsnsnsnsnsnsnsnsnsnsnsnsnsnsnsnsnsnsnsnsnsnsnsn
snLYxNxNsnFvFvFvFvsnsnsnLYxNxNsnFvFvFvFvsnsnLYxNxNsnFvFvFvFvsnsnLYxNxNsnFvFvFvFvsnsnsnsnsnsnsnsnsnsnsnsnsnsnsnsnsnsnsnsnsnsnsnsnsnsnsnsnsnsnsnsnsnsnsnsnsnsnsnsnsnsnsnsnsnsnsnsnsnsnsnsnsnsnsnsnsnsnsnsn
sniExNxNsnFvFvFvFvsnsnsniExNxNsnFvFvFvFvsnsniExNxNsnFvFvFvFvsnsniExNxNsnFvFvFvFvsnsnsnsnsnsnsnsnsnsnsnsnsnsnsnsnsnsnsnsnsnsnsnsnsnsnsnsnsnsnsnsnsnsnsnsnsnsnsnsnsnsnsnsnsnsnsnsnsnsnsnsnsnsnsnsnsnsnsnsn
snsnsnpVsnFvFvFvFvpAsnsnsnsnpVsnFvFvFvFvpAsnsnsnpVsnFvFvFvFvpAsnsnsnpVsnFvFvFvFvpAsnsnsnsnsnsnsnsnsnsnsnsnsnsnsnsnsnsnsnsnsnsnsnsnsnsnsnsnsnsnsnsnsnsnsnsnsnsnsnsnsnsnsnsnsnsnsnsnsnsnsnsnsnsnsnsnsnsnsn
snFvFvFvFvFvFvFvFvcNsnsnFvFvFvFvFvFvFvFvpHsnFvFvFvFvFvFvFvFvtLsnFvFvFvFvFvFvFvFvVlsnsnsnsnsnsnsnsnsnsnsnsnsnsnsnsnsnsnsnsnsnsnsnsnsnsnsnsnsnsnsnsnsnsnsnsnsnsnsnsnsnsnsnsnsnsnsnsnsnsnsnsnsnsnsnsnsnsnsn
snFvFvFvAKFvFvFvFvsnsnsnFvFvFvAKFvFvFvFvsnsnFvFvFvAKFvFvFvFvsnsnFvFvFvAKFvFvFvFvsnsnsnsnsnsnsnsnsnsnsnsnsnsnsnsnsnsnsnsnsnsnsnsnsnsnsnsnsnsnsnsnsnsnsnsnsnsnsnsnsnsnsnsnsnsnsnsnsnsnsnsnsnsnsnsnsnsnsnsn
snsnsnsnsnsnsnsnsnsnsnsnsnsnsnsnsnsnsnsnsnsnsnsnsnsnsnsnsnsnsnsnsnsnsnsnsnsnsnsnsnsnsnsnsnsnsnsnsnsnsnsnsnsnsnsnsnsnsnsnsnsnsnsnsnsnsnsnsnsnsnsnsnsnsnsnsnsnsnsnsnsnsnsnsnsnsnsnsnsnsnsnsnsnsnsnsnsnsnsn
snsnsnsnsnsnsnsnsnsnsnsnsnsnsnsnsnsnsnsnsnsnsnsnsnsnsnsnsnsnsnsnsnsnsnsnsnsnsnsnsnsnsnsnsnsnsnsnsnsnsnsnsnsnsnsnsnsnsnsnsnsnsnsnsnsnsnsnsnsnsnsnsnsnsnsnsnsnsnsnsnsnsnsnsnsnsnsnsnsnsnsnsnsnsnsnsnsnsnsn
snmOxNvAsnFvFvwVFvsnsnsnmOxNvAsnFvFvwVFvsnsnmOxNvAsnFvFvwVFvsnsnmOxNvAsnFvFvwVFvsnsnsnsnsnsnsnsnsnsnsnsnsnsnsnsnsnsnsnsnsnsnsnsnsnsnsnsnsnsnsnsnsnsnsnsnsnsnsnsnsnsnsnsnsnsnsnsnsnsnsnsnsnsnsnsnsnsnsnsn
snLYxNxNsnFvFvFvFvsnsnsnLYxNxNsnFvFvFvFvsnsnLYxNxNsnFvFvFvFvsnsnLYxNxNsnFvFvFvFvsnsnsnsnsnsnsnsnsnsnsnsnsnsnsnsnsnsnsnsnsnsnsnsnsnsnsnsnsnsnsnsnsnsnsnsnsnsnsnsnsnsnsnsnsnsnsnsnsnsnsnsnsnsnsnsnsnsnsnsn
sniExNxNsnFvFvFvFvsnsnsniExNxNsnFvFvFvFvsnsniExNxNsnFvFvFvFvsnsniExNxNsnFvFvFvFvsnsnsnsnsnsnsnsnsnsnsnsnsnsnsnsnsnsnsnsnsnsnsnsnsnsnsnsnsnsnsnsnsnsnsnsnsnsnsnsnsnsnsnsnsnsnsnsnsnsnsnsnsnsnsnsnsnsnsnsn
snsnsnpVsnFvFvFvFvpAsnsnsnsnpVsnFvFvFvFvpAsnsnsnpVsnFvFvFvFvpAsnsnsnpVsnFvFvFvFvpAsnsnsnsnsnsnsnsnsnsnsnsnsnsnsnsnsnsnsnsnsnsnsnsnsnsnsnsnsnsnsnsnsnsnsnsnsnsnsnsnsnsnsnsnsnsnsnsnsnsnsnsnsnsnsnsnsnsnsn
snFvFvFvFvFvFvFvFvfIsnsnFvFvFvFvFvFvFvFvEbsnFvFvFvFvFvFvFvFvaqsnFvFvFvFvFvFvFvFvBIsnsnsnsnsnsnsnsnsnsnsnsnsnsnsnsnsnsnsnsnsnsnsnsnsnsnsnsnsnsnsnsnsnsnsnsnsnsnsnsnsnsnsnsnsnsnsnsnsnsnsnsnsnsnsnsnsnsnsn
snFvFvFvAKFvFvFvFvsnsnsnFvFvFvAKFvFvFvFvsnsnFvFvFvAKFvFvFvFvsnsnFvFvFvAKFvFvFvFvsnsnsnsnsnsnsnsnsnsnsnsnsnsnsnsnsnsnsnsnsnsnsnsnsnsnsnsnsnsnsnsnsnsnsnsnsnsnsnsnsnsnsnsnsnsnsnsnsnsnsnsnsnsnsnsnsnsnsnsn
snsnsnsnsnsnsnsnsnsnsnsnsnsnsnsnsnsnsnsnsnsnsnsnsnsnsnsnsnsnsnsnsnsnsnsnsnsnsnsnsnsnsnsnsnsnsnsnsnsnsnsnsnsnsnsnsnsnsnsnsnsnsnsnsnsnsnsnsnsnsnsnsnsnsnsnsnsnsnsnsnsnsnsnsnsnsnsnsnsnsnsnsnsnsnsnsnsnsnsn
snsnsnsnsnsnsnsnsnsnsnsnsnsnsnsnsnsnsnsnsnsnsnsnsnsnsnsnsnsnsnsnsnsnsnsnsnsnsnsnsnsnsnsnsnsnsnsnsnsnsnsnsnsnsnsnsnsnsnsnsnsnsnsnsnsnsnsnsnsnsnsnsnsnsnsnsnsnsnsnsnsnsnsnsnsnsnsnsnsnsnsnsnsnsnsnsnsnsnsn
snmOxNvAsnFvFvwVFvsnsnsnmOxNvAsnFvFvwVFvsnsnmOxNvAsnFvFvwVFvsnsnmOxNvAsnFvFvwVFvsnsnsnsnsnsnsnsnsnsnsnsnsnsnsnsnsnsnsnsnsnsnsnsnsnsnsnsnsnsnsnsnsnsnsnsnsnsnsnsnsnsnsnsnsnsnsnsnsnsnsnsnsnsnsnsnsnsnsnsn
snLYxNxNsnFvFvFvFvsnsnsnLYxNxNsnFvFvFvFvsnsnLYxNxNsnFvFvFvFvsnsnLYxNxNsnFvFvFvFvsnsnsnsnsnsnsnsnsnsnsnsnsnsnsnsnsnsnsnsnsnsnsnsnsnsnsnsnsnsnsnsnsnsnsnsnsnsnsnsnsnsnsnsnsnsnsnsnsnsnsnsnsnsnsnsnsnsnsnsn
sniExNxNsnFvFvFvFvsnsnsniExNxNsnFvFvFvFvsnsniExNxNsnFvFvFvFvsnsniExNxNsnFvFvFvFvsnsnsnsnsnsnsnsnsnsnsnsnsnsnsnsnsnsnsnsnsnsnsnsnsnsnsnsnsnsnsnsnsnsnsnsnsnsnsnsnsnsnsnsnsnsnsnsnsnsnsnsnsnsnsnsnsnsnsnsn
snsnsnpVsnFvFvFvFvpAsnsnsnsnpVsnFvFvFvFvpAsnsnsnpVsnFvFvFvFvpAsnsnsnpVsnFvFvFvFvpAsnsnsnsnsnsnsnsnsnsnsnsnsnsnsnsnsnsnsnsnsnsnsnsnsnsnsnsnsnsnsnsnsnsnsnsnsnsnsnsnsnsnsnsnsnsnsnsnsnsnsnsnsnsnsnsnsnsnsn
snFvFvFvFvFvFvFvFvwNsnsnFvFvFvFvFvFvFvFvHpsnFvFvFvFvFvFvFvFvdXsnFvFvFvFvFvFvFvFvOnsnsnsnsnsnsnsnsnsnsnsnsnsnsnsnsnsnsnsnsnsnsnsnsnsnsnsnsnsnsnsnsnsnsnsnsnsnsnsnsnsnsnsnsnsnsnsnsnsnsnsnsnsnsnsnsnsnsnsn
snFvFvFvAKFvFvFvFvsnsnsnFvFvFvAKFvFvFvFvsnsnFvFvFvAKFvFvFvFvsnsnFvFvFvAKFvFvFvFvsnsnsnsnsnsnsnsnsnsnsnsnsnsnsnsnsnsnsnsnsnsnsnsnsnsnsnsnsnsnsnsnsnsnsnsnsnsnsnsnsnsnsnsnsnsnsnsnsnsnsnsnsnsnsnsnsnsnsnsn
snsnsnsnsnsnsnsnsnsnsnsnsnsnsnsnsnsnsnsnsnsnsnsnsnsnsnsnsnsnsnsnsnsnsnsnsnsnsnsnsnsnsnsnsnsnsnsnsnsnsnsnsnsnsnsnsnsnsnsnsnsnsnsnsnsnsnsnsnsnsnsnsnsnsnsnsnsnsnsnsnsnsnsnsnsnsnsnsnsnsnsnsnsnsnsnsnsnsnsn
snsnsnsnsnsnsnsnsnsnsnsnsnsnsnsnsnsnsnsnsnsnsnsnsnsnsnsnsnsnsnsnsnsnsnsnsnsnsnsnsnsnsnsnsnsnsnsnsnsnsnsnsnsnsnsnsnsnsnsnsnsnsnsnsnsnsnsnsnsnsnsnsnsnsnsnsnsnsnsnsnsnsnsnsnsnsnsnsnsnsnsnsnsnsnsnsnsnsnsn
snmOxNvAsnFvFvwVFvsnsnsnmOxNvAsnFvFvwVFvsnsnmOxNvAsnFvFvwVFvsnsnmOxNvAsnFvFvwVFvsnsnsnsnsnsnsnsnsnsnsnsnsnsnsnsnsnsnsnsnsnsnsnsnsnsnsnsnsnsnsnsnsnsnsnsnsnsnsnsnsnsnsnsnsnsnsnsnsnsnsnsnsnsnsnsnsnsnsnsn
snLYxNxNsnFvFvFvFvsnsnsnLYxNxNsnFvFvFvFvsnsnLYxNxNsnFvFvFvFvsnsnLYxNxNsnFvFvFvFvsnsnsnsnsnsnsnsnsnsnsnsnsnsnsnsnsnsnsnsnsnsnsnsnsnsnsnsnsnsnsnsnsnsnsnsnsnsnsnsnsnsnsnsnsnsnsnsnsnsnsnsnsnsnsnsnsnsnsnsn
sniExNxNsnFvFvFvFvsnsnsniExNxNsnFvFvFvFvsnsniExNxNsnFvFvFvFvsnsniExNxNsnFvFvFvFvsnsnsnsnsnsnsnsnsnsnsnsnsnsnsnsnsnsnsnsnsnsnsnsnsnsnsnsnsnsnsnsnsnsnsnsnsnsnsnsnsnsnsnsnsnsnsnsnsnsnsnsnsnsnsnsnsnsnsnsn
snsnsnpVsnFvFvFvFvpAsnsnsnsnpVsnFvFvFvFvpAsnsnsnpVsnFvFvFvFvpAsnsnsnpVsnFvFvFvFvpAsnsnsnsnsnsnsnsnsnsnsnsnsnsnsnsnsnsnsnsnsnsnsnsnsnsnsnsnsnsnsnsnsnsnsnsnsnsnsnsnsnsnsnsnsnsnsnsnsnsnsnsnsnsnsnsnsnsnsn
snFvFvFvFvFvFvFvFvUPsnsnFvFvFvFvFvFvFvFvCVsnFvFvFvFvFvFvFvFvOqsnFvFvFvFvFvFvFvFvOFsnsnsnsnsnsnsnsnsnsnsnsnsnsnsnsnsnsnsnsnsnsnsnsnsnsnsnsnsnsnsnsnsnsnsnsnsnsnsnsnsnsnsnsnsnsnsnsnsnsnsnsnsnsnsnsnsnsnsn
snFvFvFvAKFvFvFvFvsnsnsnFvFvFvAKFvFvFvFvsnsnFvFvFvAKFvFvFvFvsnsnFvFvFvAKFvFvFvFvsnsnsnsnsnsnsnsnsnsnsnsnsnsnsnsnsnsnsnsnsnsnsnsnsnsnsnsnsnsnsnsnsnsnsnsnsnsnsnsnsnsnsnsnsnsnsnsnsnsnsnsnsnsnsnsnsnsnsnsn
snsnsnsnsnsnsnsnsnsnsnsnsnsnsnsnsnsnsnsnsnsnsnsnsnsnsnsnsnsnsnsnsnsnsnsnsnsnsnsnsnsnsnsnsnsnsnsnsnsnsnsnsnsnsnsnsnsnsnsnsnsnsnsnsnsnsnsnsnsnsnsnsnsnsnsnsnsnsnsnsnsnsnsnsnsnsnsnsnsnsnsnsnsnsnsnsnsnsnsn
snsnsnsnsnsnsnsnsnsnsnsnsnsnsnsnsnsnsnsnsnsnsnsnsnsnsnsnsnsnsnsnsnsnsnsnsnsnsnsnsnsnsnsnsnsnsnsnsnsnsnsnsnsnsnsnsnsnsnsnsnsnsnsnsnsnsnsnsnsnsnsnsnsnsnsnsnsnsnsnsnsnsnsnsnsnsnsnsnsnsnsnsnsnsnsnsnsnsnsn
snmOxNvAsnFvFvwVFvsnsnsnmOxNvAsnFvFvwVFvsnsnmOxNvAsnFvFvwVFvsnsnmOxNvAsnFvFvwVFvsnsnsnsnsnsnsnsnsnsnsnsnsnsnsnsnsnsnsnsnsnsnsnsnsnsnsnsnsnsnsnsnsnsnsnsnsnsnsnsnsnsnsnsnsnsnsnsnsnsnsnsnsnsnsnsnsnsnsnsn
snLYxNxNsnFvFvFvFvsnsnsnLYxNxNsnFvFvFvFvsnsnLYxNxNsnFvFvFvFvsnsnLYxNxNsnFvFvFvFvsnsnsnsnsnsnsnsnsnsnsnsnsnsnsnsnsnsnsnsnsnsnsnsnsnsnsnsnsnsnsnsnsnsnsnsnsnsnsnsnsnsnsnsnsnsnsnsnsnsnsnsnsnsnsnsnsnsnsnsn
sniExNxNsnFvFvFvFvsnsnsniExNxNsnFvFvFvFvsnsniExNxNsnFvFvFvFvsnsniExNxNsnFvFvFvFvsnsnsnsnsnsnsnsnsnsnsnsnsnsnsnsnsnsnsnsnsnsnsnsnsnsnsnsnsnsnsnsnsnsnsnsnsnsnsnsnsnsnsnsnsnsnsnsnsnsnsnsnsnsnsnsnsnsnsnsn
snsnsnpVsnFvFvFvFvpAsnsnsnsnpVsnFvFvFvFvpAsnsnsnpVsnFvFvFvFvpAsnsnsnpVsnFvFvFvFvpAsnsnsnsnsnsnsnsnsnsnsnsnsnsnsnsnsnsnsnsnsnsnsnsnsnsnsnsnsnsnsnsnsnsnsnsnsnsnsnsnsnsnsnsnsnsnsnsnsnsnsnsnsnsnsnsnsnsnsn
snFvFvFvFvFvFvFvFvbtsnsnFvFvFvFvFvFvFvFviVsnFvFvFvFvFvFvFvFvkvsnFvFvFvFvFvFvFvFvAmsnsnsnsnsnsnsnsnsnsnsnsnsnsnsnsnsnsnsnsnsnsnsnsnsnsnsnsnsnsnsnsnsnsnsnsnsnsnsnsnsnsnsnsnsnsnsnsnsnsnsnsnsnsnsnsnsnsnsn
snFvFvFvAKFvFvFvFvsnsnsnFvFvFvAKFvFvFvFvsnsnFvFvFvAKFvFvFvFvsnsnFvFvFvAKFvFvFvFvsnsnsnsnsnsnsnsnsnsnsnsnsnsnsnsnsnsnsnsnsnsnsnsnsnsnsnsnsnsnsnsnsnsnsnsnsnsnsnsnsnsnsnsnsnsnsnsnsnsnsnsnsnsnsnsnsnsnsnsn
snsnsnsnsnsnsnsnsnsnsnsnsnsnsnsnsnsnsnsnsnsnsnsnsnsnsnsnsnsnsnsnsnsnsnsnsnsnsnsnsnsnsnsnsnsnsnsnsnsnsnsnsnsnsnsnsnsnsnsnsnsnsnsnsnsnsnsnsnsnsnsnsnsnsnsnsnsnsnsnsnsnsnsnsnsnsnsnsnsnsnsnsnsnsnsnsnsnsnsn
snsnsnsnsnsnsnsnsnsnsnsnsnsnsnsnsnsnsnsnsnsnsnsnsnsnsnsnsnsnsnsnsnsnsnsnsnsnsnsnsnsnsnsnsnsnsnsnsnsnsnsnsnsnsnsnsnsnsnsnsnsnsnsnsnsnsnsnsnsnsnsnsnsnsnsnsnsnsnsnsnsnsnsnsnsnsnsnsnsnsnsnsnsnsnsnsnsnsnsn
snmOxNvAsnFvFvwVFvsnsnsnmOxNvAsnFvFvwVFvsnsnmOxNvAsnFvFvwVFvsnsnmOxNvAsnFvFvwVFvsnsnsnsnsnsnsnsnsnsnsnsnsnsnsnsnsnsnsnsnsnsnsnsnsnsnsnsnsnsnsnsnsnsnsnsnsnsnsnsnsnsnsnsnsnsnsnsnsnsnsnsnsnsnsnsnsnsnsnsn
snLYxNxNsnFvFvFvFvsnsnsnLYxNxNsnFvFvFvFvsnsnLYxNxNsnFvFvFvFvsnsnLYxNxNsnFvFvFvFvsnsnsnsnsnsnsnsnsnsnsnsnsnsnsnsnsnsnsnsnsnsnsnsnsnsnsnsnsnsnsnsnsnsnsnsnsnsnsnsnsnsnsnsnsnsnsnsnsnsnsnsnsnsnsnsnsnsnsnsn
sniExNxNsnFvFvFvFvsnsnsniExNxNsnFvFvFvFvsnsniExNxNsnFvFvFvFvsnsniExNxNsnFvFvFvFvsnsnsnsnsnsnsnsnsnsnsnsnsnsnsnsnsnsnsnsnsnsnsnsnsnsnsnsnsnsnsnsnsnsnsnsnsnsnsnsnsnsnsnsnsnsnsnsnsnsnsnsnsnsnsnsnsnsnsnsn
snsnsnpVsnFvFvFvFvpAsnsnsnsnpVsnFvFvFvFvpAsnsnsnpVsnFvFvFvFvpAsnsnsnpVsnFvFvFvFvpAsnsnsnsnsnsnsnsnsnsnsnsnsnsnsnsnsnsnsnsnsnsnsnsnsnsnsnsnsnsnsnsnsnsnsnsnsnsnsnsnsnsnsnsnsnsnsnsnsnsnsnsnsnsnsnsnsnsnsn
snFvFvFvFvFvFvFvFvdrsnsnFvFvFvFvFvFvFvFvYzsnFvFvFvFvFvFvFvFvaCsnFvFvFvFvFvFvFvFvWZsnsnsnsnsnsnsnsnsnsnsnsnsnsnsnsnsnsnsnsnsnsnsnsnsnsnsnsnsnsnsnsnsnsnsnsnsnsnsnsnsnsnsnsnsnsnsnsnsnsnsnsnsnsnsnsnsnsnsn
snFvFvFvAKFvFvFvFvsnsnsnFvFvFvAKFvFvFvFvsnsnFvFvFvAKFvFvFvFvsnsnFvFvFvAKFvFvFvFvsnsnsnsnsnsnsnsnsnsnsnsnsnsnsnsnsnsnsnsnsnsnsnsnsnsnsnsnsnsnsnsnsnsnsnsnsnsnsnsnsnsnsnsnsnsnsnsnsnsnsnsnsnsnsnsnsnsnsnsn
snsnsnsnsnsnsnsnsnsnsnsnsnsnsnsnsnsnsnsnsnsnsnsnsnsnsnsnsnsnsnsnsnsnsnsnsnsnsnsnsnsnsnsnsnsnsnsnsnsnsnsnsnsnsnsnsnsnsnsnsnsnsnsnsnsnsnsnsnsnsnsnsnsnsnsnsnsnsnsnsnsnsnsnsnsnsnsnsnsnsnsnsnsnsnsnsnsnsnsn
snsnsnsnsnsnsnsnsnsnsnsnsnsnsnsnsnsnsnsnsnsnsnsnsnsnsnsnsnsnsnsnsnsnsnsnsnsnsnsnsnsnsnsnsnsnsnsnsnsnsnsnsnsnsnsnsnsnsnsnsnsnsnsnsnsnsnsnsnsnsnsnsnsnsnsnsnsnsnsnsnsnsnsnsnsnsnsnsnsnsnsnsnsnsnsnsnsnsnsn
snmOxNvAsnFvFvwVFvsnsnsnmOxNvAsnFvFvwVFvsnsnmOxNvAsnFvFvwVFvsnsnmOxNvAsnFvFvwVFvsnsnsnsnsnsnsnsnsnsnsnsnsnsnsnsnsnsnsnsnsnsnsnsnsnsnsnsnsnsnsnsnsnsnsnsnsnsnsnsnsnsnsnsnsnsnsnsnsnsnsnsnsnsnsnsnsnsnsnsn
snLYxNxNsnFvFvFvFvsnsnsnLYxNxNsnFvFvFvFvsnsnLYxNxNsnFvFvFvFvsnsnLYxNxNsnFvFvFvFvsnsnsnsnsnsnsnsnsnsnsnsnsnsnsnsnsnsnsnsnsnsnsnsnsnsnsnsnsnsnsnsnsnsnsnsnsnsnsnsnsnsnsnsnsnsnsnsnsnsnsnsnsnsnsnsnsnsnsnsn
sniExNxNsnFvFvFvFvsnsnsniExNxNsnFvFvFvFvsnsniExNxNsnFvFvFvFvsnsniExNxNsnFvFvFvFvsnsnsnsnsnsnsnsnsnsnsnsnsnsnsnsnsnsnsnsnsnsnsnsnsnsnsnsnsnsnsnsnsnsnsnsnsnsnsnsnsnsnsnsnsnsnsnsnsnsnsnsnsnsnsnsnsnsnsnsn
snsnsnpVsnFvFvFvFvpAsnsnsnsnpVsnFvFvFvFvpAsnsnsnpVsnFvFvFvFvpAsnsnsnpVsnFvFvFvFvpAsnsnsnsnsnsnsnsnsnsnsnsnsnsnsnsnsnsnsnsnsnsnsnsnsnsnsnsnsnsnsnsnsnsnsnsnsnsnsnsnsnsnsnsnsnsnsnsnsnsnsnsnsnsnsnsnsnsnsn
snFvFvFvFvFvFvFvFvmYsnsnFvFvFvFvFvFvFvFvsMsnFvFvFvFvFvFvFvFvkesnFvFvFvFvFvFvFvFvsSsnsnsnsnsnsnsnsnsnsnsnsnsnsnsnsnsnsnsnsnsnsnsnsnsnsnsnsnsnsnsnsnsnsnsnsnsnsnsnsnsnsnsnsnsnsnsnsnsnsnsnsnsnsnsnsnsnsnsn
snFvFvFvAKFvFvFvFvsnsnsnFvFvFvAKFvFvFvFvsnsnFvFvFvAKFvFvFvFvsnsnFvFvFvAKFvFvFvFvsnsnsnsnsnsnsnsnsnsnsnsnsnsnsnsnsnsnsnsnsnsnsnsnsnsnsnsnsnsnsnsnsnsnsnsnsnsnsnsnsnsnsnsnsnsnsnsnsnsnsnsnsnsnsnsnsnsnsnsn
snsnsnsnsnsnsnsnsnsnsnsnsnsnsnsnsnsnsnsnsnsnsnsnsnsnsnsnsnsnsnsnsnsnsnsnsnsnsnsnsnsnsnsnsnsnsnsnsnsnsnsnsnsnsnsnsnsnsnsnsnsnsnsnsnsnsnsnsnsnsnsnsnsnsnsnsnsnsnsnsnsnsnsnsnsnsnsnsnsnsnsnsnsnsnsnsnsnsnsn
snsnsnsnsnsnsnsnsnsnsnsnsnsnsnsnsnsnsnsnsnsnsnsnsnsnsnsnsnsnsnsnsnsnsnsnsnsnsnsnsnsnsnsnsnsnsnsnsnsnsnsnsnsnsnsnsnsnsnsnsnsnsnsnsnsnsnsnsnsnsnsnsnsnsnsnsnsnsnsnsnsnsnsnsnsnsnsnsnsnsnsnsnsnsnsnsnsnsnsn
snsnsnsnsnsnsnsnsnsnsnsnsnsnsnsnsnsnsnsnsnsnsnsnsnsnsnsnsnsnsnsnsnsnsnsnsnsnsnsnsnsnsnsnsnsnsnsnsnsnsnsnsnsnsnsnsnsnsnsnsnsnsnsnsnsnsnsnsnsnsnsnsnsnsnsnsnsnsnsnsnsnsnsnsnsnsnsnsnsnsnsnsnsnsnsnsnsnsnsn
snsnsnsnsnsnsnsnsnsnsnsnsnsnsnsnsnsnsnsnsnsnsnsnsnsnsnsnsnsnsnsnsnsnsnsnsnsnsnsnsnsnsnsnsnsnsnsnsnsnsnsnsnsnsnsnsnsnsnsnsnsnsnsnsnsnsnsnsnsnsnsnsnsnsnsnsnsnsnsnsnsnsnsnsnsnsnsnsnsnsnsnsnsnsnsnsnsnsnsn
snsnsnsnsnsnsnsnsnsnsnsnsnsnsnsnsnsnsnsnsnsnsnsnsnsnsnsnsnsnsnsnsnsnsnsnsnsnsnsnsnsnsnsnsnsnsnsnsnsnsnsnsnsnsnsnsnsnsnsnsnsnsnsnsnsnsnsnsnsnsnsnsnsnsnsnsnsnsnsnsnsnsnsnsnsnsnsnsnsnsnsnsnsnsnsnsnsnsnsn
"}
